el ajo - garlic
el atún - tuna
la cereza - cherry
las costillas - ribs
el pavo - turkey
la zanahoria - carrot
los camarones - shrimp
el postre - dessert
el aderezo - dressing
la fresa - strawberry
la galleta - cookie
el pastel - cake
el aguacate - avocado
la harina - flour
el aceite - oil
la chuleta - porkchop
las carnes - meat
el cordero - mutton
el maracuyá - passion fruit
el perejil - parsley
las uvas - grapes
la carne molida - ground beef
las papas - potatoes
asada - roasted
la sopa - soup
la pimienta - pepper


el cuchillo - knife
la cuchara  - spoon 
el tenedor - fork
la jarra - pitcher
el mantel - tablecloth
mesa de madera - wooden table
el vaso - glass 
el sacacorchos - the corkscrew
el plato - plate
la taza - cup
la copa - glass
la servilleta - napkin
la bandeja - tray
la cucharita - little spoon 
el bol - bowl
la botella - bottle


los campesinos - farmers
la receta - recipe